@MapData  80, 25, 48, 48, ../image/mapchip3.png
@Back
-1, -1, -1, -1, -1, -1, -1, -1, -1, -1, -1, -1, -1, -1, -1, -1, -1, -1, -1, -1, -1, -1, -1, -1, -1, -1, -1, -1, -1, -1, -1, -1, -1, -1, -1, -1, -1, -1, -1, -1, -1, -1, -1, -1, -1, -1, -1, -1, -1, -1, -1, -1, -1, -1, -1, -1, -1, -1, -1, -1, -1, -1, -1, -1, -1, -1, -1, -1, -1, -1, -1, -1, -1, -1, -1, -1, -1, -1, -1, -1, 
-1, -1, -1, -1, -1, -1, -1, -1, -1, -1, -1, -1, -1, -1, -1, -1, -1, -1, -1, -1, -1, -1, -1, -1, -1, -1, -1, -1, -1, -1, -1, -1, -1, -1, -1, -1, -1, -1, -1, -1, -1, -1, -1, -1, -1, -1, -1, -1, -1, -1, -1, -1, -1, -1, -1, -1, -1, -1, -1, -1, -1, -1, -1, -1, -1, -1, -1, -1, -1, -1, -1, -1, -1, -1, -1, -1, -1, -1, -1, -1, 
-1, -1, -1, -1, -1, -1, -1, -1, -1, -1, -1, -1, -1, -1, -1, -1, -1, -1, -1, -1, -1, -1, -1, -1, -1, -1, -1, -1, -1, -1, -1, -1, -1, -1, -1, -1, -1, -1, -1, -1, -1, -1, -1, -1, -1, -1, -1, -1, -1, -1, -1, -1, -1, -1, -1, -1, -1, -1, -1, -1, -1, -1, -1, -1, -1, -1, -1, -1, -1, -1, -1, -1, -1, -1, -1, -1, -1, -1, -1, -1, 
-1, -1, -1, -1, -1, -1, -1, -1, -1, -1, -1, -1, -1, -1, -1, -1, -1, -1, -1, -1, -1, -1, -1, -1, -1, -1, -1, -1, -1, -1, -1, -1, -1, -1, -1, -1, -1, -1, -1, -1, -1, -1, -1, -1, -1, -1, -1, -1, -1, -1, -1, -1, -1, -1, -1, -1, -1, -1, -1, -1, -1, -1, -1, -1, -1, -1, -1, -1, -1, -1, -1, -1, -1, -1, -1, -1, -1, -1, -1, -1, 
-1, -1, -1, -1, -1, -1, -1, -1, -1, -1, -1, -1, -1, -1, -1, -1, -1, -1, -1, -1, -1, -1, -1, -1, -1, -1, -1, -1, -1, -1, -1, -1, -1, -1, -1, -1, -1, -1, -1, -1, -1, -1, -1, -1, -1, -1, -1, -1, -1, -1, -1, -1, -1, -1, -1, -1, -1, -1, -1, -1, -1, -1, -1, -1, -1, -1, -1, -1, -1, -1, -1, -1, -1, -1, -1, -1, -1, -1, -1, -1, 
-1, -1, -1, -1, -1, -1, -1, -1, -1, -1, -1, -1, -1, -1, -1, -1, -1, -1, -1, -1, -1, -1, -1, -1, -1, -1, -1, -1, -1, -1, -1, -1, -1, -1, -1, -1, -1, -1, -1, -1, -1, -1, -1, -1, -1, -1, -1, -1, -1, -1, -1, -1, -1, -1, -1, -1, -1, -1, -1, -1, -1, -1, -1, -1, -1, -1, -1, -1, -1, -1, -1, -1, -1, -1, -1, -1, -1, -1, -1, -1, 
-1, -1, -1, -1, -1, -1, -1, -1, -1, -1, -1, -1, -1, -1, -1, -1, -1, -1, -1, -1, -1, -1, -1, -1, -1, -1, -1, -1, -1, -1, -1, -1, -1, -1, -1, -1, -1, -1, -1, -1, -1, -1, -1, -1, -1, -1, -1, -1, -1, -1, -1, -1, -1, -1, -1, -1, -1, -1, -1, -1, -1, -1, -1, -1, -1, -1, -1, -1, -1, -1, -1, -1, -1, -1, -1, -1, -1, -1, -1, -1, 
-1, -1, -1, -1, -1, -1, -1, -1, -1, -1, -1, -1, -1, -1, -1, -1, -1, 2003, 2006, 2006, 2006, 2006, 2006, 2006, 2006, 2006, 2006, 2006, 2006, 2006, 2006, 2006, 2006, 2006, 2006, 2006, 2006, 2006, 2006, 2006, 2002, 2001, 2001, 2001, 2001, 2001, 2001, 2001, 2001, 2001, 2001, 2001, 2001, 2001, 2001, 2001, 2001, 2001, 2001, 2001, 2003, -1, -1, -1, -1, -1, -1, -1, -1, -1, -1, -1, -1, -1, -1, -1, -1, -1, -1, -1, 
-1, -1, -1, -1, -1, -1, -1, -1, -1, -1, -1, -1, -1, -1, -1, -1, -1, 3003, 3011, 3011, 3011, 3011, 3011, 3011, 3011, 3011, 3011, 3011, 3011, 3011, 3011, 3011, 3011, 3011, 2011, 3011, 3011, 3011, 3011, 3011, 3002, 3001, 3001, 3001, 3001, 3001, 3001, 3001, 3001, 3001, 3001, 3001, 3001, 3001, 3001, 3001, 3001, 3001, 3001, 3001, 3003, -1, -1, -1, -1, -1, -1, -1, -1, -1, -1, -1, -1, -1, -1, -1, -1, -1, -1, -1, 
-1, -1, -1, -1, -1, -1, -1, -1, -1, -1, -1, -1, -1, -1, -1, -1, -1, 3003, 3011, 3011, 3011, 3011, 2011, 3011, 3011, 3011, 3011, 2011, 3011, 3011, 3011, 3011, 3011, 3011, 3011, 3011, 3011, 3011, 3011, 3011, 3002, 3001, 3001, 3001, 3001, 3001, 3001, 3001, 3001, 3001, 3001, 3001, 3001, 3001, 3001, 3001, 3001, 3001, 3001, 3001, 3003, -1, -1, -1, -1, -1, -1, -1, -1, -1, -1, -1, -1, -1, -1, -1, -1, -1, -1, -1, 
-1, -1, -1, -1, -1, -1, -1, -1, -1, -1, -1, -1, -1, -1, -1, -1, -1, 3003, 3011, 3011, 3011, 3011, 3011, 3011, 3011, 3011, 3011, 3011, 3011, 3011, 3011, 3011, 3011, 3011, 3011, 3011, 3011, 3011, 3011, 3011, 3002, 3001, 3001, 3001, 3001, 3001, 3001, 3001, 3001, 3001, 3001, 3001, 3001, 3001, 3001, 3001, 3001, 3001, 3001, 3001, 3003, -1, -1, -1, -1, -1, -1, -1, -1, -1, -1, -1, -1, -1, -1, -1, -1, -1, -1, -1, 
-1, -1, -1, -1, -1, -1, -1, -1, -1, -1, -1, -1, -1, -1, -1, -1, -1, 3003, 3011, 3011, 3011, 3011, 2011, 3011, 3011, 3011, 3011, 2011, 3011, 3011, 3011, 3011, 3011, 3011, 2011, 3011, 3011, 3011, 3011, 3011, 3002, 3001, 3001, 3001, 3001, 3001, 3001, 3001, 3001, 3001, 3001, 3001, 3001, 3001, 3001, 3001, 3001, 3001, 3001, 3001, 3003, -1, -1, -1, -1, -1, -1, -1, -1, -1, -1, -1, -1, -1, -1, -1, -1, -1, -1, -1, 
2001, 2001, 2001, 2001, 2001, 2001, 2001, 2001, 2001, 2001, 2001, 2001, 2001, 2001, 2001, 2001, 2001, 3003, 3011, 3011, 3011, 3011, 3011, 3011, 3011, 3011, 3011, 3011, 3011, 3011, 3011, 3011, 3011, 3011, 3011, 3011, 3011, 4008, 4010, 4009, 3002, 3001, 3001, 3001, 3001, 3001, 3001, 3001, 3001, 3001, 3001, 3001, 3001, 3001, 3001, 3001, 3001, 3001, 3001, 3001, 3003, -1, -1, -1, -1, -1, -1, -1, -1, -1, -1, -1, -1, -1, -1, -1, -1, -1, -1, -1, 
2010, 2009, 2008, 2009, 2008, 2009, 2008, 2006, 2009, 2008, 2006, 2009, 2008, 2006, 2009, 2008, 2006, 2009, 3011, 3011, 3011, 3011, 2011, 3011, 3011, 3011, 3011, 2011, 3011, 3011, 3011, 3011, 3011, 3011, 3011, 3011, 3011, 5008, 5010, 5009, 3002, 3001, 3001, 3001, 3001, 3001, 3001, 3001, 3001, 3001, 3001, 3001, 3001, 3001, 3001, 3001, 3001, 3001, 3001, 3001, 3003, -1, -1, -1, -1, -1, -1, -1, -1, -1, -1, -1, -1, -1, -1, -1, -1, -1, -1, -1, 
3010, 3013, 3012, 3013, 3012, 3013, 3012, 3011, 3013, 3012, 3011, 3013, 3012, 3011, 3013, 3012, 3011, 3013, 3011, 3011, 3011, 3011, 3011, 3011, 3011, 3011, 3011, 3011, 3011, 3011, 3011, 3011, 3011, 2002, 2001, 2001, 2001, 2001, 2001, 2001, 3001, 3001, 3001, 3001, 3001, 3001, 3001, 3001, 3001, 3001, 3001, 3001, 3001, 3001, 3001, 3001, 3001, 3001, 3001, 3001, 3003, -1, -1, -1, -1, -1, -1, -1, -1, -1, -1, -1, -1, -1, -1, -1, -1, -1, -1, -1, 
3001, 3013, 3012, 3013, 3012, 3013, 3012, 3011, 3013, 3012, 3011, 3013, 3012, 3011, 3013, 3012, 3011, 3013, 3011, 3011, 3011, 3011, 2011, 3011, 3011, 3011, 3011, 2011, 3011, 3011, 3011, 3011, 3011, 3002, 3001, 3001, 3001, 3001, 3001, 3001, 3001, 3001, 3001, 3001, 3001, 3001, 3001, 3001, 3001, 3001, 3001, 3001, 3001, 3001, 3001, 3001, 3001, 3001, 3001, 3001, 3003, -1, -1, -1, -1, -1, -1, -1, -1, -1, -1, -1, -1, -1, -1, -1, -1, -1, -1, -1, 
3001, 3001, 3012, 3013, 3012, 3013, 3012, 3011, 3013, 3012, 3011, 3013, 3012, 3011, 3013, 3012, 3011, 3013, 3011, 3011, 3011, 3011, 3011, 3011, 3011, 3011, 3011, 3011, 3011, 3011, 3011, 3011, 3011, 3002, 3001, 3001, 3001, 3001, 3001, 3001, 3001, 3001, 3001, 3001, 3001, 3001, 3001, 3001, 3001, 3001, 3001, 3001, 3001, 3001, 3001, 3001, 3001, 3001, 3001, 3001, 3003, -1, -1, -1, -1, -1, -1, -1, -1, -1, -1, -1, -1, -1, -1, -1, -1, -1, -1, -1, 
3001, 3001, 3001, 3013, 3012, 3013, 3012, 2011, 3013, 3012, 2011, 3013, 3012, 2011, 3013, 3012, 2011, 3013, 3011, 3011, 3011, 3011, 2011, 3011, 3011, 3011, 3011, 2011, 3011, 3011, 3011, 3011, 3011, 3002, 3001, 3001, 3001, 3001, 3001, 3001, 3001, 3001, 3001, 3001, 3001, 3001, 3001, 3001, 3001, 3001, 3001, 3001, 3001, 3001, 3001, 3001, 3001, 3001, 3001, 3001, 3003, -1, -1, -1, -1, -1, -1, -1, -1, -1, -1, -1, -1, -1, -1, -1, -1, -1, -1, -1, 
3001, 3001, 3001, 3001, 3012, 3013, 3012, 3011, 3013, 3012, 3011, 3013, 3012, 3011, 3013, 3012, 3011, 3013, 3011, 3011, 3011, 3011, 3011, 3011, 3011, 3011, 3011, 3011, 3011, 3011, 3011, 3011, 3011, 3002, 3001, 3001, 3001, 3001, 3001, 3001, 3001, 3001, 3001, 3001, 3001, 3001, 3001, 3001, 3001, 3001, 3001, 3001, 3001, 3001, 3001, 3001, 3001, 3001, 3001, 3001, 3003, -1, -1, -1, -1, -1, -1, -1, -1, -1, -1, -1, -1, -1, -1, -1, -1, -1, -1, -1, 
3001, 3001, 3001, 3001, 3001, 3013, 3012, 3011, 3013, 3012, 3011, 3013, 3012, 3011, 3013, 3012, 3011, 3013, 3011, 3011, 3011, 3011, 2011, 3011, 3011, 3011, 3011, 2011, 3011, 3011, 3011, 3011, 3011, 3002, 3001, 3001, 3001, 3001, 3001, 3001, 3001, 3001, 3001, 3001, 3001, 3001, 3001, 3001, 3001, 3001, 3001, 3001, 3001, 3001, 3001, 3001, 3001, 3001, 3001, 3001, 3003, -1, -1, -1, -1, -1, -1, -1, -1, -1, -1, -1, -1, -1, -1, -1, -1, -1, -1, -1, 
3001, 3001, 3001, 3001, 3001, 3001, 3012, 3006, 3009, 3008, 3011, 3013, 3012, 3006, 3009, 3012, 3011, 3013, 3006, 3006, 3006, 3011, 3011, 3011, 2002, 3001, 3003, 3011, 3011, 3011, 3011, 3011, 3011, 3002, 3001, 3001, 3001, 3001, 3001, 3001, 3001, 3001, 3001, 3001, 3001, 3001, 3001, 3001, 3001, 3001, 3001, 3001, 3001, 3001, 3001, 3001, 3001, 3001, 3001, 3001, 3003, -1, -1, -1, -1, -1, -1, -1, -1, -1, -1, -1, -1, -1, -1, -1, -1, -1, -1, -1, 
3001, 3001, 3001, 3001, 3001, 3001, 3001, 2001, 2001, 2003, 3011, 3013, 3012, 2002, 2003, 3012, 3011, 3013, 2002, 2001, 2003, 3011, 3011, 3011, 3002, 3001, 3003, 3011, 3011, 3011, 3011, 3011, 3011, 3002, 3001, 3001, 3001, 3001, 3001, 3001, 3001, 3001, 3001, 3001, 3001, 3001, 3001, 3001, 3001, 3001, 3001, 3001, 3001, 3001, 3001, 3001, 3001, 3001, 3001, 3001, 3003, -1, -1, -1, -1, -1, -1, -1, -1, -1, -1, -1, -1, -1, -1, -1, -1, -1, -1, -1, 
3001, 3001, 3001, 3001, 3001, 3001, 3001, 3001, 3001, 3003, 3011, 3013, 3012, 3002, 3003, 3012, 3011, 3013, 3002, 3001, 3003, 3011, 3011, 3011, 3002, 3001, 3003, 3011, 3011, 3011, 3011, 3011, 3011, 3002, 3001, 3001, 3001, 3001, 3001, 3001, 3001, 3001, 3001, 3001, 3001, 3001, 3001, 3001, 3001, 3001, 3001, 3001, 3001, 3001, 3001, 3001, 3001, 3001, 3001, 3001, 3003, -1, -1, -1, -1, -1, -1, -1, -1, -1, -1, -1, -1, -1, -1, -1, -1, -1, -1, -1, 
3001, 3001, 3001, 3001, 3001, 3001, 3001, 3001, 3001, 3003, 3011, 3013, 3012, 3002, 3003, 3012, 3011, 3013, 3002, 3001, 3003, 3011, 3011, 3011, 3002, 3001, 3003, 3011, 3011, 3011, 3011, 3011, 3011, 3002, 3001, 3001, 3001, 3001, 3001, 3001, 3001, 3001, 3001, 3001, 3001, 3001, 3001, 3001, 3001, 3001, 3001, 3001, 3001, 3001, 3001, 3001, 3001, 3001, 3001, 3001, 3003, -1, -1, -1, -1, -1, -1, -1, -1, -1, -1, -1, -1, -1, -1, -1, -1, -1, -1, -1, 
3001, 3001, 3001, 3001, 3001, 3001, 3001, 3001, 3001, 3003, 3006, 3009, 3008, 3002, 3003, 3008, 3006, 3009, 3002, 3001, 3003, 3006, 3006, 3006, 3002, 3001, 3003, 3006, 3006, 3006, 3006, 3006, 3006, 3002, 3001, 3001, 3001, 3001, 3001, 3001, 3001, 3001, 3001, 3001, 3001, 3001, 3001, 3001, 3001, 3001, 3001, 3001, 3001, 3001, 3001, 3001, 3001, 3001, 3001, 3001, 3003, -1, -1, -1, -1, -1, -1, -1, -1, -1, -1, -1, -1, -1, -1, -1, -1, -1, -1, -1, 
@Fore
-1, -1, -1, -1, -1, -1, -1, -1, -1, -1, -1, -1, -1, -1, -1, -1, -1, -1, -1, -1, -1, -1, -1, -1, -1, -1, -1, -1, -1, -1, -1, -1, -1, -1, -1, -1, -1, -1, -1, -1, -1, -1, -1, -1, -1, -1, -1, -1, -1, -1, -1, -1, -1, -1, -1, -1, -1, -1, -1, -1, -1, -1, -1, -1, -1, -1, -1, -1, -1, -1, -1, -1, -1, -1, -1, -1, -1, -1, -1, -1, 
-1, -1, -1, -1, -1, -1, -1, -1, -1, -1, -1, -1, -1, -1, -1, -1, -1, -1, -1, -1, -1, -1, -1, -1, -1, -1, -1, -1, -1, -1, -1, -1, -1, -1, -1, -1, -1, -1, -1, -1, -1, -1, -1, -1, -1, -1, -1, -1, -1, -1, -1, -1, -1, -1, -1, -1, -1, -1, -1, -1, -1, -1, -1, -1, -1, -1, -1, -1, -1, -1, -1, -1, -1, -1, -1, -1, -1, -1, -1, -1, 
-1, -1, -1, -1, -1, -1, -1, -1, -1, -1, -1, -1, -1, -1, -1, -1, -1, -1, -1, -1, -1, -1, -1, -1, -1, -1, -1, -1, -1, -1, -1, -1, -1, -1, -1, -1, -1, -1, -1, -1, -1, -1, -1, -1, -1, -1, -1, -1, -1, -1, -1, -1, -1, -1, -1, -1, -1, -1, -1, -1, -1, -1, -1, -1, -1, -1, -1, -1, -1, -1, -1, -1, -1, -1, -1, -1, -1, -1, -1, -1, 
-1, -1, -1, -1, -1, -1, -1, -1, -1, -1, -1, -1, -1, -1, -1, -1, -1, -1, -1, -1, -1, -1, -1, -1, -1, -1, -1, -1, -1, -1, -1, -1, -1, -1, -1, -1, -1, -1, -1, -1, -1, -1, -1, -1, -1, -1, -1, -1, -1, -1, -1, -1, -1, -1, -1, -1, -1, -1, -1, -1, -1, -1, -1, -1, -1, -1, -1, -1, -1, -1, -1, -1, -1, -1, -1, -1, -1, -1, -1, -1, 
-1, -1, -1, -1, -1, -1, -1, -1, -1, -1, -1, -1, -1, -1, -1, -1, -1, -1, -1, -1, -1, -1, -1, -1, -1, -1, -1, -1, -1, -1, -1, -1, -1, -1, -1, -1, -1, -1, -1, -1, -1, -1, -1, -1, -1, -1, -1, -1, -1, -1, -1, -1, -1, -1, -1, -1, -1, -1, -1, -1, -1, -1, -1, -1, -1, -1, -1, -1, -1, -1, -1, -1, -1, -1, -1, -1, -1, -1, -1, -1, 
-1, -1, -1, -1, -1, -1, -1, -1, -1, -1, -1, -1, -1, -1, -1, -1, -1, -1, -1, -1, -1, -1, -1, -1, -1, -1, -1, -1, -1, -1, -1, -1, -1, -1, -1, -1, -1, -1, -1, -1, -1, -1, -1, -1, -1, -1, -1, -1, -1, -1, -1, -1, -1, -1, -1, -1, -1, -1, -1, -1, -1, -1, -1, -1, -1, -1, -1, -1, -1, -1, -1, -1, -1, -1, -1, -1, -1, -1, -1, -1, 
-1, -1, -1, -1, -1, -1, -1, -1, -1, -1, -1, -1, -1, -1, -1, -1, -1, -1, -1, -1, -1, -1, -1, -1, -1, -1, -1, -1, -1, -1, -1, -1, -1, -1, -1, -1, -1, -1, -1, -1, -1, -1, -1, -1, -1, -1, -1, -1, -1, -1, -1, -1, -1, -1, -1, -1, -1, -1, -1, -1, -1, -1, -1, -1, -1, -1, -1, -1, -1, -1, -1, -1, -1, -1, -1, -1, -1, -1, -1, -1, 
-1, -1, -1, -1, -1, -1, -1, -1, -1, -1, -1, -1, -1, -1, -1, -1, -1, -1, -1, -1, -1, -1, -1, -1, -1, -1, -1, -1, -1, -1, -1, -1, -1, -1, -1, -1, -1, -1, -1, -1, -1, -1, -1, -1, -1, -1, -1, -1, -1, -1, -1, -1, -1, -1, -1, -1, -1, -1, -1, -1, -1, -1, -1, -1, -1, -1, -1, -1, -1, -1, -1, -1, -1, -1, -1, -1, -1, -1, -1, -1, 
-1, -1, -1, -1, -1, -1, -1, -1, -1, -1, -1, -1, -1, -1, -1, -1, -1, -1, -1, -1, -1, -1, -1, -1, -1, -1, -1, -1, -1, -1, -1, -1, -1, -1, -1, -1, -1, -1, -1, -1, -1, -1, -1, -1, -1, -1, -1, -1, -1, -1, -1, -1, -1, -1, -1, -1, -1, -1, -1, -1, -1, -1, -1, -1, -1, -1, -1, -1, -1, -1, -1, -1, -1, -1, -1, -1, -1, -1, -1, -1, 
-1, -1, -1, -1, -1, -1, -1, -1, -1, -1, -1, -1, -1, -1, -1, -1, -1, -1, -1, -1, -1, -1, -1, -1, -1, -1, -1, -1, -1, -1, -1, -1, -1, -1, -1, -1, -1, -1, -1, -1, -1, -1, -1, -1, -1, -1, -1, -1, -1, -1, -1, -1, -1, -1, -1, -1, -1, -1, -1, -1, -1, -1, -1, -1, -1, -1, -1, -1, -1, -1, -1, -1, -1, -1, -1, -1, -1, -1, -1, -1, 
-1, -1, -1, -1, -1, -1, -1, -1, -1, -1, -1, -1, -1, -1, -1, -1, -1, -1, -1, -1, -1, -1, -1, -1, -1, -1, -1, -1, -1, -1, -1, -1, -1, -1, -1, -1, -1, -1, -1, -1, -1, -1, -1, -1, -1, -1, -1, -1, -1, -1, -1, -1, -1, -1, -1, -1, -1, -1, -1, -1, -1, -1, -1, -1, -1, -1, -1, -1, -1, -1, -1, -1, -1, -1, -1, -1, -1, -1, -1, -1, 
-1, -1, -1, -1, -1, -1, -1, -1, -1, -1, -1, -1, -1, -1, -1, -1, -1, -1, -1, -1, -1, -1, -1, -1, -1, -1, -1, -1, -1, -1, -1, -1, -1, -1, -1, -1, -1, -1, -1, -1, -1, -1, -1, -1, -1, -1, -1, -1, -1, -1, -1, -1, -1, -1, -1, -1, -1, -1, -1, -1, -1, -1, -1, -1, -1, -1, -1, -1, -1, -1, -1, -1, -1, -1, -1, -1, -1, -1, -1, -1, 
-1, -1, -1, -1, -1, -1, -1, -1, -1, -1, -1, -1, -1, -1, -1, -1, -1, -1, -1, -1, -1, -1, -1, -1, -1, -1, -1, -1, -1, -1, -1, -1, -1, -1, -1, -1, -1, -1, -1, -1, -1, -1, -1, -1, -1, -1, -1, -1, -1, -1, -1, -1, -1, -1, -1, -1, -1, -1, -1, -1, -1, -1, -1, -1, -1, -1, -1, -1, -1, -1, -1, -1, -1, -1, -1, -1, -1, -1, -1, -1, 
-1, -1, -1, -1, -1, -1, -1, -1, -1, -1, -1, -1, -1, -1, -1, -1, -1, -1, -1, -1, -1, -1, -1, -1, -1, -1, -1, -1, -1, -1, -1, -1, -1, -1, -1, -1, -1, -1, -1, -1, -1, -1, -1, -1, -1, -1, -1, -1, -1, -1, -1, -1, -1, -1, -1, -1, -1, -1, -1, -1, -1, -1, -1, -1, -1, -1, -1, -1, -1, -1, -1, -1, -1, -1, -1, -1, -1, -1, -1, -1, 
-1, -1, -1, -1, -1, -1, -1, -1, -1, -1, -1, -1, -1, -1, -1, -1, -1, -1, -1, -1, -1, -1, -1, -1, -1, -1, -1, -1, -1, 3004, 2004, -1, -1, -1, -1, -1, -1, -1, -1, -1, -1, -1, -1, -1, -1, -1, -1, -1, -1, -1, -1, -1, -1, -1, -1, -1, -1, -1, -1, -1, -1, -1, -1, -1, -1, -1, -1, -1, -1, -1, -1, -1, -1, -1, -1, -1, -1, -1, -1, -1, 
-1, 5000, -1, -1, -1, -1, -1, -1, -1, -1, -1, -1, -1, -1, -1, -1, -1, -1, -1, -1, -1, -1, -1, -1, 3004, 2004, -1, -1, -1, -1, -1, -1, -1, -1, -1, -1, -1, -1, -1, -1, -1, -1, -1, -1, -1, -1, -1, -1, -1, -1, -1, -1, -1, -1, -1, -1, -1, -1, -1, -1, -1, -1, -1, -1, -1, -1, -1, -1, -1, -1, -1, -1, -1, -1, -1, -1, -1, -1, -1, -1, 
-1, -1, 5000, -1, -1, -1, -1, -1, -1, -1, -1, -1, -1, -1, -1, -1, -1, -1, -1, 3004, 2004, -1, -1, -1, -1, -1, -1, -1, -1, -1, -1, -1, -1, -1, -1, -1, -1, -1, -1, -1, -1, -1, -1, -1, -1, -1, -1, -1, -1, -1, -1, -1, -1, -1, -1, -1, -1, -1, -1, -1, -1, -1, -1, -1, -1, -1, -1, -1, -1, -1, -1, -1, -1, -1, -1, -1, -1, -1, -1, -1, 
-1, -1, -1, 5000, -1, -1, -1, -1, -1, -1, -1, -1, -1, -1, -1, -1, -1, -1, -1, -1, -1, -1, -1, -1, -1, -1, -1, -1, -1, -1, -1, -1, -1, -1, -1, -1, -1, -1, -1, -1, -1, -1, -1, -1, -1, -1, -1, -1, -1, -1, -1, -1, -1, -1, -1, -1, -1, -1, -1, -1, -1, -1, -1, -1, -1, -1, -1, -1, -1, -1, -1, -1, -1, -1, -1, -1, -1, -1, -1, -1, 
-1, -1, -1, -1, 5000, -1, -1, -1, -1, -1, -1, -1, -1, -1, -1, -1, -1, -1, -1, -1, -1, -1, -1, -1, -1, -1, -1, -1, -1, 3004, 2004, -1, -1, -1, -1, -1, -1, -1, -1, -1, -1, -1, -1, -1, -1, -1, -1, -1, -1, -1, -1, -1, -1, -1, -1, -1, -1, -1, -1, -1, -1, -1, -1, -1, -1, -1, -1, -1, -1, -1, -1, -1, -1, -1, -1, -1, -1, -1, -1, -1, 
-1, -1, -1, -1, -1, 5000, -1, -1, -1, -1, -1, -1, -1, -1, -1, -1, -1, -1, -1, -1, -1, -1, -1, -1, -1, -1, -1, -1, -1, -1, -1, -1, -1, -1, -1, -1, -1, -1, -1, -1, -1, -1, -1, -1, -1, -1, -1, -1, -1, -1, -1, -1, -1, -1, -1, -1, -1, -1, -1, -1, -1, -1, -1, -1, -1, -1, -1, -1, -1, -1, -1, -1, -1, -1, -1, -1, -1, -1, -1, -1, 
-1, -1, -1, -1, -1, -1, 5000, -1, -1, -1, -1, -1, -1, -1, -1, -1, -1, -1, -1, -1, -1, -1, -1, -1, -1, -1, -1, -1, -1, -1, -1, -1, -1, -1, -1, -1, -1, -1, -1, -1, -1, -1, -1, -1, -1, -1, -1, -1, -1, -1, -1, -1, -1, -1, -1, -1, -1, -1, -1, -1, -1, -1, -1, -1, -1, -1, -1, -1, -1, -1, -1, -1, -1, -1, -1, -1, -1, -1, -1, -1, 
-1, -1, -1, -1, -1, -1, -1, -1, -1, -1, -1, -1, -1, -1, -1, -1, -1, -1, -1, -1, -1, -1, -1, -1, -1, -1, -1, -1, -1, -1, -1, -1, -1, -1, -1, -1, -1, -1, -1, -1, -1, -1, -1, -1, -1, -1, -1, -1, -1, -1, -1, -1, -1, -1, -1, -1, -1, -1, -1, -1, -1, -1, -1, -1, -1, -1, -1, -1, -1, -1, -1, -1, -1, -1, -1, -1, -1, -1, -1, -1, 
-1, -1, -1, -1, -1, -1, -1, -1, -1, -1, -1, -1, -1, -1, -1, -1, -1, -1, -1, -1, -1, -1, -1, -1, -1, -1, -1, -1, -1, -1, -1, -1, -1, -1, -1, -1, -1, -1, -1, -1, -1, -1, -1, -1, -1, -1, -1, -1, -1, -1, -1, -1, -1, -1, -1, -1, -1, -1, -1, -1, -1, -1, -1, -1, -1, -1, -1, -1, -1, -1, -1, -1, -1, -1, -1, -1, -1, -1, -1, -1, 
-1, -1, -1, -1, -1, -1, -1, -1, -1, -1, -1, -1, -1, -1, -1, -1, -1, -1, -1, -1, -1, -1, -1, -1, -1, -1, -1, -1, -1, -1, -1, -1, -1, -1, -1, -1, -1, -1, -1, -1, -1, -1, -1, -1, -1, -1, -1, -1, -1, -1, -1, -1, -1, -1, -1, -1, -1, -1, -1, -1, -1, -1, -1, -1, -1, -1, -1, -1, -1, -1, -1, -1, -1, -1, -1, -1, -1, -1, -1, -1, 
-1, -1, -1, -1, -1, -1, -1, -1, -1, -1, -1, -1, -1, -1, -1, -1, -1, -1, -1, -1, -1, -1, -1, -1, -1, -1, -1, -1, -1, -1, -1, -1, -1, -1, -1, -1, -1, -1, -1, -1, -1, -1, -1, -1, -1, -1, -1, -1, -1, -1, -1, -1, -1, -1, -1, -1, -1, -1, -1, -1, -1, -1, -1, -1, -1, -1, -1, -1, -1, -1, -1, -1, -1, -1, -1, -1, -1, -1, -1, -1, 
@MapLine  42
   -2,   36,       -2,  948,    1.00000,-0.00000
  240,  912,      336, 1008,    0.70711,-0.70711
  336, 1008,      480, 1008,    0.00000,-1.00000
  480, 1008,      480, 1200,    1.00000,-0.00000
  480, 1200,      624, 1200,    0.00000,-1.00000
  624, 1200,      624, 1008,    -1.00000,-0.00000
  624, 1008,      720, 1008,    0.00000,-1.00000
  720, 1008,      720, 1200,    1.00000,-0.00000
  720, 1200,      864, 1200,    0.00000,-1.00000
  864, 1200,      864, 1008,    -1.00000,-0.00000
  864, 1008,     1008, 1008,    0.00000,-1.00000
 1008, 1008,     1008, 1200,    1.00000,-0.00000
 1008, 1200,     1152, 1200,    0.00000,-1.00000
 1152, 1200,     1152,  960,    -1.00000,-0.00000
 1152,  960,     1296,  960,    0.00000,-1.00000
 1296,  960,     1296, 1200,    1.00000,-0.00000
 1296, 1200,     1600, 1200,    0.00000,-1.00000
 1600, 1200,     1584,  672,    -0.99954,0.03029
 1584,  672,     1920,  672,    0.00000,-1.00000
 1920,  672,     1900,    0,    -0.99956,0.02975
 1900,    0,        0,    0,    0.00000,1.00000
  912,  768,     1008,  768,    0.00000,-1.00000
 1008,  768,     1008,  796,    1.00000,-0.00000
 1008,  796,      912,  796,    0.00000,1.00000
  912,  796,      912,  768,    -1.00000,-0.00000
 1152,  720,     1248,  720,    0.00000,-1.00000
 1248,  720,     1248,  748,    1.00000,-0.00000
 1248,  748,     1152,  748,    0.00000,1.00000
 1152,  748,     1152,  720,    -1.00000,-0.00000
 1392,  864,     1488,  864,    0.00000,-1.00000
 1488,  864,     1488,  892,    1.00000,-0.00000
 1488,  892,     1392,  892,    0.00000,1.00000
 1392,  892,     1392,  864,    -1.00000,-0.00000
 1392,  672,     1488,  672,    0.00000,-1.00000
 1488,  672,     1488,  700,    1.00000,-0.00000
 1488,  700,     1392,  700,    0.00000,1.00000
 1392,  700,     1392,  672,    -1.00000,-0.00000
   48,  720,      240,  912,    0.70711,-0.70711
    0,  716,       44,  716,    0.00000,-1.00000
    0,  628,        4,  712,    0.99887,-0.04757
  860,  624,        4,  624,    0.00000,1.00000
  980,    4,      864,  624,    0.98294,0.18391
@EvtMap  22
  480, 1152,     3,  1,   0
  528, 1152,     3,  1,   0
  576, 1152,     3,  1,   0
  720, 1152,     3,  1,   0
  768, 1152,     3,  1,   0
  816, 1152,     3,  1,   0
 1008, 1152,     3,  1,   0
 1056, 1152,     3,  1,   0
 1104, 1152,     3,  1,   0
 1296, 1152,     3,  1,   0
 1344, 1152,     3,  1,   0
 1392, 1152,     3,  1,   0
 1440, 1152,     3,  1,   0
 1488, 1152,     3,  1,   0
 1536, 1152,     3,  1,   0
  384,  960,     3,  4,   0
  912,  960,     3,  4,   0
 1200,  850,     2,  10,   0
 1824,  624,     2,  20,   0
    0,  671,     1,  0,   0
 1177,  652,     2, 40, 0
 1638,  626,     3, 8, 0
